2	2	1	1	2	-1	-1	-1	-1	2
2	2	1	1	2	2	2	-1	-1	2
1	1	1	1	1	1	2	2	2	2
2	2	2	-1	10	2	1	1	1	1
10	10	2	-1	10	10	1	1	1	1
10	10	2	-1	-1	-1	1	1	1	1
2	2	2	1	2	2	2	1	2	2
-1	2	2	1	2	1	1	1	1	2
-1	-1	2	2	2	2	2	10	10	2
-1	-1	-1	2	2	10	10	10	10	1
